##############
#............#
#....#########
#............#
###########..#
#............#
##############